w r r r y y b w r b e g b b g
b r r b b e y r r g g b w w y
b b y r w e b g r w r y r b g
b b r g w y b g w r e r y b r
r w w b y r r b g g b b y r e
r r y w e g y r w r g b b b b
y w r e b g r b b b g y r r w
e g y r b b w y g w b b r r r
g b b b r y b w r r r e w y g
r r g r w b b e y w b y r g b
r b g r b w b e y r g y w b r
g b b b y y r r r g e r w b w
r w r b y b r y g r b b w e g
r b y b b w w g r b e y r g r
g b b w r b e w g b r y r y r
y g b e w b r y w b r r g r b
y b w e b r y g r g b r w b r
r y e b b r b b w r y g w g r
y b g r b b e b w r w r g y r
w w b b r y b y b r r e g g r
r g b r b y w w r g b r y e b
w y r b r y e w b g r b r g b
b b b r r r y w e r g g w b y
r b r w r w g b b e y y b g r
b w w g y e b r r b b r r y g
g w e y r w r b r b y g b r b
y w r w b y r g g r b e b r b
y e w r r b r b b r g g y b w
y w r r b g b g w r y b r e b
w b e b r b r r r g y y g b w