r w b b e b r r y r w r b r y
r w b r b e y r b w r r y r b
b b r w b b w y r r r e y r r
b w r b b y r e r r r r w b y
b b w r y b b w r y r r r r e
b r r r y w b b b r y w r e r
r r y y b r w b b e r b r r w
r r b b e y r r w y w r r b b
b r r r w r y b b b r w e y r
r b e b r y r w w b r b r r y
w b y b r r e r r b r w b r y
b b r r r e y r r w r b b y w
b r w b r r y b r e r r b y w
r b w y r b e r r b r y r b w
r r r r b r b y b b w y r w e
r r r y r w b e r b b b y w r
b y b r w r r r w e r y b b r
r b w r y y r r r e w b b b r
w b r w y y e r r r b r r b b
b r b r y r r r w b b w e y r
r y r r w w r y b b r r e b b
y b r r r b e w w b r y r r b
b b r y r y w r r b b e w r r
r y r w w r b r r r b y b e b
b y r r b e r r b r y b r w w
r b y r y r w w r b b e r r b
b r r w r w y y b b r r b r e
w y b w r r e b b r r r r b y
r b y e y w b b r w r r b r r
r r b w b y b r w r y b r r e
r r w r r r e b y b r w b b y
b y b r e r w r r w r y b r b
b r r e w y b b r r r y w r b
y r w r b b r b w r e b r r y
y r b r r r w w e y r b b b r
r r r b y r y b b r w e r w b
b r b y w b r y b r r r r e w
b r e y r w r w b b r r r b y
r y r r b w w r y b r e r b b
b b r b r w r e r y r w r y b
y b b w r r b b r e w r r r y
r e r b r r r b y b y b w w r
y b e r b w r r w y r b b r r
r y b b y r r b w w r r b r e
b r y w b r e r r b r w y r b
w r b e y r b b r r w b r r y
b y r b r b r r w y w r r b e
b y b w b w r r r e r r y b r
e b y r w w y r r r b r b b r
b y r b y r r b w r r r e b w