g p r g b y r w y e r w b r p
w y p b r y r e p r g b g r w
y b r g b e g w p r w r y p r
b r w r p g g e p w r b r y y
y p y w e b r r w r b p g r g
y e y r r r p g w b g b w p r
r w b p p g r y y e w g r b r
y w p w r g y r e b r p b r g
p r w r r r g y g b p y w e b
r w e w b p y y g g r r b r p